first_name	last_name	job_title	email
Roshelle	Baskerville	Budget/Accounting Analyst II	rbaskerville0@weibo.com
Riane	Mitkcov	Financial Analyst	rmitkcov1@a8.net
Loydie	Radish	Director of Sales	lradish2@biblegateway.com
Blaire	Michiel	Software Test Engineer IV	bmichiel3@nsw.gov.au
Willy	Wagenen	Director of Sales	wwagenen4@cdbaby.com
Blakelee	Tolworth	Engineer III	btolworth5@independent.co.uk
Jacqui	Carles	Administrative Assistant IV	jcarles6@europa.eu
Anett	Brightey	Speech Pathologist	abrightey7@fastcompany.com
Adelind	Lampet	VP Sales	alampet8@yellowbook.com
Sherri	Candwell	Senior Cost Accountant	scandwell9@ustream.tv
Jandy	Roman	Health Coach I	jromana@networksolutions.com
Addie	Sollis	Budget/Accounting Analyst IV	asollisb@people.com.cn
Mendel	McFadin	Automation Specialist IV	mmcfadinc@so-net.ne.jp
Aeriell	Bottrill	Staff Accountant I	abottrilld@unblog.fr
Revkah	Jovovic	Safety Technician I	rjovovice@amazonaws.com
Nicolle	Cagan	Executive Secretary	ncaganf@unc.edu
Jeremias	MacLachlan	Physical Therapy Assistant	jmaclachlang@sogou.com
Ram	Gilham	Accounting Assistant IV	rgilhamh@cloudflare.com
Caddric	Morton	Geological Engineer	cmortoni@narod.ru
Brooke	Watsham	Information Systems Manager	bwatshamj@tmall.com
Stevie	Cicchelli	Associate Professor	scicchellik@moonfruit.com
Sauncho	Glowacz	Help Desk Technician	sglowaczl@mapquest.com
Win	Gent	Help Desk Operator	wgentm@answers.com
Obed	Brinkler	Analog Circuit Design manager	obrinklern@liveinternet.ru
Tris	Hills	Administrative Assistant I	thillso@flickr.com
Barris	O'Feeney	Electrical Engineer	bofeeneyp@walmart.com
Ailis	Gwilt	Senior Financial Analyst	agwiltq@marketwatch.com
Giorgia	Puddifer	Compensation Analyst	gpuddiferr@nsw.gov.au
Antoine	Whellans	Media Manager III	awhellanss@wordpress.com
Delbert	Prettejohns	Tax Accountant	dprettejohnst@soup.io
Maris	Ince	Compensation Analyst	minceu@accuweather.com
Carol-jean	Wanne	Director of Sales	cwannev@mac.com
Carmine	Schole	Structural Analysis Engineer	cscholew@ezinearticles.com
Simona	Chaplyn	Teacher	schaplynx@businessweek.com
Archibaldo	Hardy-Piggin	Human Resources Manager	ahardypigginy@i2i.jp
Cathrine	Roofe	Professor	croofez@statcounter.com
Riccardo	Soeiro	Editor	rsoeiro10@bloomberg.com
Aubrey	Ellett	Programmer Analyst II	aellett11@goo.gl
Dita	Reynold	Tax Accountant	dreynold12@people.com.cn
Celene	Abrahamson	Structural Analysis Engineer	cabrahamson13@amazon.com
Gerti	Mohun	Administrative Assistant I	gmohun14@ifeng.com
Orion	Yurtsev	Compensation Analyst	oyurtsev15@thetimes.co.uk
Vere	Saby	Administrative Assistant III	vsaby16@devhub.com
Gregoire	Bigglestone	Electrical Engineer	gbigglestone17@newyorker.com
Hillie	Stentiford	Computer Systems Analyst III	hstentiford18@topsy.com
Dianna	McQuarter	Recruiter	dmcquarter19@4shared.com
Carolin	Bowler	Data Coordiator	cbowler1a@seattletimes.com
Burnard	Merle	Staff Scientist	bmerle1b@answers.com
Rowland	Drinkall	Product Engineer	rdrinkall1c@twitpic.com
Levi	Gisby	VP Sales	lgisby1d@linkedin.com
Crawford	Hawse	Pharmacist	chawse1e@pen.io
Sophia	Genthner	Sales Associate	sgenthner1f@vk.com
Donia	Barwack	Community Outreach Specialist	dbarwack1g@php.net
Janella	Greenin	Associate Professor	jgreenin1h@nps.gov
Jillene	Holttom	Physical Therapy Assistant	jholttom1i@so-net.ne.jp
Row	Weald	Payment Adjustment Coordinator	rweald1j@fema.gov
Coralyn	Mallinar	Environmental Specialist	cmallinar1k@odnoklassniki.ru
Odette	Fogg	Compensation Analyst	ofogg1l@reverbnation.com
Adria	Bayman	Product Engineer	abayman1m@dagondesign.com
Alidia	Meagher	Recruiting Manager	ameagher1n@marriott.com
Mark	Sogg	Executive Secretary	msogg1o@gov.uk
Doralin	Cuardall	Research Nurse	dcuardall1p@ox.ac.uk
Miltie	Caush	Registered Nurse	mcaush1q@stanford.edu
Rubin	Troake	Librarian	rtroake1r@wufoo.com
Trixie	O' Flaherty	GIS Technical Architect	toflaherty1s@ifeng.com
Matty	Hallan	Research Associate	mhallan1t@shop-pro.jp
Bertina	Petley	Assistant Media Planner	bpetley1u@newyorker.com
Jorey	Vogelein	Financial Analyst	jvogelein1v@miibeian.gov.cn
Dominik	Hearon	Financial Advisor	dhearon1w@macromedia.com
Kevin	Lindblom	Business Systems Development Analyst	klindblom1x@nymag.com
Brad	De Bruin	Information Systems Manager	bdebruin1y@clickbank.net
Pearla	Decourt	Environmental Tech	pdecourt1z@weebly.com
Kathlin	Forryan	Software Consultant	kforryan20@baidu.com
Ellis	Cheater	Programmer I	echeater21@tiny.cc
Goran	Sisley	Information Systems Manager	gsisley22@indiegogo.com
Kelcey	Cheak	Business Systems Development Analyst	kcheak23@sciencedirect.com
Tarah	O'Bradain	Account Representative II	tobradain24@kickstarter.com
Codie	McCathie	Analog Circuit Design manager	cmccathie25@example.com
Aggi	Broun	Associate Professor	abroun26@thetimes.co.uk
Gusti	Kilcoyne	Web Designer I	gkilcoyne27@theglobeandmail.com
Manolo	Crosser	Director of Sales	mcrosser28@networksolutions.com
Fayette	Farnall	Budget/Accounting Analyst I	ffarnall29@chronoengine.com
Diana	Loughton	Clinical Specialist	dloughton2a@ft.com
Daron	Feeley	Recruiting Manager	dfeeley2b@wufoo.com
Grayce	Shewry	Junior Executive	gshewry2c@mozilla.org
Brett	Keunemann	Account Coordinator	bkeunemann2d@purevolume.com
Tulley	Maskelyne	Programmer Analyst IV	tmaskelyne2e@youtu.be
Farr	Josifovitz	Chief Design Engineer	fjosifovitz2f@zimbio.com
Nicolas	Irlam	Office Assistant IV	nirlam2g@networksolutions.com
Janeczka	Mariner	Sales Representative	jmariner2h@cocolog-nifty.com
Man	Kibbee	Technical Writer	mkibbee2i@pbs.org
Missie	Scowcroft	Financial Advisor	mscowcroft2j@topsy.com
Wynn	Bugs	General Manager	wbugs2k@nasa.gov
Lyndell	Cominoli	Automation Specialist II	lcominoli2l@behance.net
Elton	Wehnerr	Human Resources Assistant III	ewehnerr2m@webnode.com
Viole	Want	Quality Engineer	vwant2n@businesswire.com
Ulla	Lonsdale	Staff Scientist	ulonsdale2o@kickstarter.com
Padgett	Bellino	Social Worker	pbellino2p@soup.io
Jordan	Wofenden	Computer Systems Analyst IV	jwofenden2q@google.nl
Darius	Birnie	General Manager	dbirnie2r@canalblog.com
Anselm	Abramowitz	Human Resources Manager	aabramowitz2s@nyu.edu
Carney	Gerhts	Legal Assistant	cgerhts2t@wsj.com
Lettie	Ferrarin	Sales Representative	lferrarin2u@imageshack.us
Nathanial	Hawler	Account Representative I	nhawler2v@blog.com
Kinnie	Deniskevich	Dental Hygienist	kdeniskevich2w@tripod.com
Nettie	Andric	VP Sales	nandric2x@google.com
Niall	Charlwood	Marketing Manager	ncharlwood2y@histats.com
Elwin	Collyear	Chief Design Engineer	ecollyear2z@army.mil
Robbie	Brommage	Database Administrator IV	rbrommage30@ovh.net
Kelley	Prewett	Research Nurse	kprewett31@blog.com
Lizzy	Sergant	Systems Administrator I	lsergant32@sogou.com
Wain	Lettsom	Recruiting Manager	wlettsom33@marketwatch.com
Bobbi	Baitman	Office Assistant III	bbaitman34@hud.gov
Carmine	Ingre	Help Desk Technician	cingre35@ustream.tv
Charlie	Nelle	Help Desk Operator	cnelle36@apple.com
Jeremie	McCurtain	Nurse Practicioner	jmccurtain37@mashable.com
Mahala	Sworne	Environmental Specialist	msworne38@wikispaces.com
Lilyan	Siddon	Civil Engineer	lsiddon39@hatena.ne.jp
Gae	Elgie	Structural Analysis Engineer	gelgie3a@ucoz.ru
Eal	Sketchley	Quality Control Specialist	esketchley3b@artisteer.com
Jayne	Frugier	Software Test Engineer II	jfrugier3c@google.ca
Mahala	Ebbins	Electrical Engineer	mebbins3d@ox.ac.uk
Betsy	Gasquoine	Human Resources Manager	bgasquoine3e@ebay.co.uk
Mohandis	Pohling	Payment Adjustment Coordinator	mpohling3f@networksolutions.com
Fin	Ingerman	Quality Engineer	fingerman3g@mashable.com
Pooh	McGroarty	Systems Administrator III	pmcgroarty3h@wikimedia.org
Erhart	Fagan	Senior Cost Accountant	efagan3i@vinaora.com
Karina	O'Dowgaine	Account Representative II	kodowgaine3j@ow.ly
Christabella	Betteney	Information Systems Manager	cbetteney3k@nydailynews.com
Seana	McCambrois	Environmental Tech	smccambrois3l@about.com
Giustino	Minton	Accounting Assistant II	gminton3m@discovery.com
Ardis	Fri	Community Outreach Specialist	afri3n@pen.io
Hardy	Penner	Engineer IV	hpenner3o@google.com.br
Susannah	Fuente	Nurse Practicioner	sfuente3p@digg.com
Cori	Whicher	Dental Hygienist	cwhicher3q@vinaora.com
Clemmy	Ruckman	Automation Specialist III	cruckman3r@goo.gl
Essie	Pilmer	Electrical Engineer	epilmer3s@hp.com
Camala	Dearan	Environmental Specialist	cdearan3t@ucoz.ru
Jedd	Olivella	Administrative Assistant I	jolivella3u@sphinn.com
Talbot	Roubay	Administrative Officer	troubay3v@google.de
Mack	Skalls	Research Nurse	mskalls3w@tuttocitta.it
Kendricks	Egle of Germany	Information Systems Manager	kegleofgermany3x@moonfruit.com
Gilbertina	Vasilischev	Chief Design Engineer	gvasilischev3y@timesonline.co.uk
Byran	Roscoe	Research Assistant IV	broscoe3z@constantcontact.com
Flem	Sacco	Media Manager III	fsacco40@netscape.com
Nancey	Maciejak	Health Coach I	nmaciejak41@friendfeed.com
Trenna	Scawn	Editor	tscawn42@sohu.com
Deny	Forten	Director of Sales	dforten43@4shared.com
Rem	Vennard	Software Consultant	rvennard44@nasa.gov
Zacharias	Carrack	Clinical Specialist	zcarrack45@nymag.com
Hermina	Canto	Senior Financial Analyst	hcanto46@macromedia.com
Corella	Mushrow	VP Sales	cmushrow47@ca.gov
Nicol	Bywaters	Research Associate	nbywaters48@arizona.edu
Cleon	Adamkiewicz	Senior Financial Analyst	cadamkiewicz49@qq.com
Danit	Pendre	Environmental Tech	dpendre4a@umich.edu
Salome	De Ruel	Budget/Accounting Analyst I	sderuel4b@goodreads.com
Jeanette	Bernon	VP Sales	jbernon4c@indiegogo.com
Cissiee	Doerr	Assistant Professor	cdoerr4d@hp.com
Dionne	Pulford	Accounting Assistant I	dpulford4e@redcross.org
Jordon	Swafford	Assistant Professor	jswafford4f@businessinsider.com
Allsun	Gwatkin	Project Manager	agwatkin4g@tamu.edu
Clerc	Yurov	Tax Accountant	cyurov4h@china.com.cn
Lilla	Hurton	Data Coordiator	lhurton4i@angelfire.com
Gregor	Joret	Food Chemist	gjoret4j@mozilla.org
Jed	Forst	Structural Engineer	jforst4k@unc.edu
Foster	Krikorian	Speech Pathologist	fkrikorian4l@multiply.com
Nadeen	McDonnell	Senior Editor	nmcdonnell4m@nymag.com
Nedi	Huckfield	Associate Professor	nhuckfield4n@weather.com
Tab	O'Hannigan	VP Marketing	tohannigan4o@cnet.com
Anabella	Scrimgeour	Programmer IV	ascrimgeour4p@independent.co.uk
Hilary	Swire	Senior Quality Engineer	hswire4q@sourceforge.net
Leandra	Thomen	Web Designer III	lthomen4r@amazonaws.com
Freedman	Sweeten	Associate Professor	fsweeten4s@sun.com
Geri	Saunper	Computer Systems Analyst I	gsaunper4t@cafepress.com